243848264
587518518
812007044
258866144
914500207
915849575
1140641067
399928449